   o      o       o
 ||||************||||
 |||**************|||
 ||****************||
 |******************|
 ********************
 ********************
{********************}
 ********************
 ********************
 |******************|
 ||****************||
 |||**************|||
 ||||************||||
   v      v       v