          ******
          ******
          ******
          ******
          ******
            ||
            ||
******  **********  ******
******  **********  ******
******||**********||******
******||**********||******
******  **********  ******
******  **********  ******
            ||
            ||
          ******
          ******
          ******
          ******
          ******