   o                    o
********             ********
********             ********
********             ********
********             ********       
*****************************
*****************************
       ***************
        *************
        *************
        *************
        *************
        *************
       ***************
*****************************
*****************************
********             ********
********             ********
********             ********
********             ********
    o                   o