   o      o       o
 ||||************||||
 |||**************|||
 ||****************||
 |******************|
 ********************
 ********************
x********************x
 ********************
 ********************
 |******************|
 ||****************||
 |||**************|||
 ||||************||||
   o      o       o