          ******
          ******
          ******
          ******          
           ||
           ||
******  *******  ******
******||*******||******
******||*******||******
******  *******  ******
           ||
           ||      
          ******
          ******
          ******
          ******