   t                t
 ******          ******
 ******          ******
l******          ******r
 ******          ******
 ******          ******
 ******    t     ******
 ******||||||||||******
l******||||||||||******r
 ******||||||||||******
 ******||||||||||******
 ******    b     ******
 ******          ******
 ******          ******
l******          ******r
 ******          ******
 ******          ******
   b                b